-------------
|##         |
|L          |
|           :
|@=         |
-------------

@ Lee
= Bed
: Closed Door
# Desk
L Chair
